    ╔═════╦═════╦═════╦═════╦═════════════╗
    ║▓   O║▓   O║▓   O║▓   O║  ☊  ☊  ☊ ║   
    ║     ║     ║     ║     ║             ║
    ║ 牢1 ║ 牢2 ║ 牢3 ║ 牢4 ║             ║
══╦╦╩┄┄┅┅┅╩┄┄┅┅┅╩┄┄┅┅┅╩┄┄┅┅┅╣             ║
 0┇┇           走廊         ┇  调教室  ]> ║
══╩╩╦┄┄┅┅┅╦┄┄┅┅┅╦┄┄┅┅┅╦┄┄┅┅┅╣             ║ 
    ║ 牢5 ║ 牢6 ║ 牢7 ║ 牢8 ║             ║
    ║     ║     ║     ║     ║         ┌───╢
    ║O  ▓ ║O   ▓║O   ▓║O   ▓║ ʭʭ   ▲ │≈≈≈║ 
    ╚═════╩═════╩═════╩═════╩═════════╧═══╝